1: gạch ko phá đc
2: gạch phá đc
3: Lava, chông
4: cửa
5: Floaters
6: Domes
7: Jumpers
8: Insect
9: Orbs
10: worms
11: Skulls
12: Mines

383 5 1631 1113 18 16 0 0 0 0 24 16 25 16 24 17 25 17 24 18 25 18
384 5 1835 1084 18 16 0 0 0 0 28 16 28 17 28 18
385 5 1949 1080 18 16 0 0 0 0 30 16 30 17 30 18
386 5 121 1134 18 16 0 0 0 0 1 16 2 16 3 16 4 16 1 17 2 17 3 17 4 17 1 18 2 18 3 18 4 18
387 5 154 1123 18 16 0 0 0 0 1 16 2 16 3 16 4 16 1 17 2 17 3 17 4 17 1 18 2 18 3 18 4 18
388 5 173 1135 18 16 0 0 0 0 1 16 2 16 3 16 4 16 1 17 2 17 3 17 4 17 1 18 2 18 3 18 4 18
389 5 565 1287 18 16 0 0 0 0 8 19 9 19 10 19 8 20 9 20 10 20
390 5 647 1291 18 16 0 0 0 0 8 19 9 19 10 19 8 20 9 20 10 20
391 5 1660 1635 18 16 0 0 0 0 24 24 25 24 26 24 27 24 24 25 25 25 26 25 27 25 24 26 25 26 26 26 27 26
392 5 1705 1513 18 16 0 0 0 0 24 23 25 23 26 23 27 23 24 24 25 24 26 24 27 24
393 5 1658 1491 18 16 0 0 0 0 24 23 25 23 26 23 27 23 24 24 25 24 26 24 27 24
394 5 1656 1369 18 16 0 0 0 0 24 21 25 21 26 21 24 22 25 22 26 22
395 6 1323 1066 18 16 0 0 0 0 20 16 21 16 20 17 21 17
396 6 280 1176 18 16 0 0 0 0 3 18 4 18
397 6 158 87 18 16 0 0 0 0 1 1 2 1 3 1 4 1 5 1
398 6 206 87 18 16 0 0 0 0 1 1 2 1 3 1 4 1 5 1
399 6 545 1876 18 16 0 0 0 0 8 27 9 27 10 27 8 28 9 28 10 28 8 29 9 29 10 29
400 6 666 1903 18 16 0 0 0 0 10 29 11 29 12 29 13 29 14 29 10 30 11 30 12 30 13 30 14 30
401 7 64 974 16 27 0 0 0 0 0 14 1 14 2 14 0 15 1 15 2 15
402 7 952 577 16 27 0 0 0 0 14 8 15 8 14 9 15 9
403 7 834 574 16 27 0 0 0 0 12 8 13 8 12 9 13 9
404 7 854 462 16 27 0 0 0 0 12 6 13 6 12 7 13 7
405 7 2024 1437 16 27 0 0 0 0 31 21 31 22
406 8 376 595 16 13 0 0 0 0 4 8 5 8 6 8 4 9 5 9 6 9 4 10 5 10 6 10
407 8 334 726 16 13 0 0 0 0 4 10 5 10 6 10 4 11 5 11 6 11 4 12 5 12 6 12
408 8 373 500 16 13 0 0 0 0 4 7 5 7 6 7 4 8 5 8 6 8
409 8 891 1312 16 13 0 0 0 0 13 20 14 20 13 21 14 21
410 8 763 1443 16 13 0 0 0 0 11 22 12 22 11 23 12 23
411 8 769 1211 16 13 0 0 0 0 11 18 12 18 11 19 12 19
412 8 836 679 16 13 0 0 0 0 12 10 13 10 12 11 13 11
413 8 934 661 16 13 0 0 0 0 14 10 15 10 14 11 15 11
414 8 863 1584 16 13 0 0 0 0 13 24 14 24 13 25 14 25
415 8 857 1839 16 13 0 0 0 0 12 28 13 28 14 28 12 29 13 29 14 29
416 9 211 457 16 16 0 0 0 0 2 7 3 7 4 7
417 9 120 333 16 16 0 0 0 0 0 5 1 5 2 5 3 5 4 5 5 5
418 9 255 335 16 16 0 0 0 0 0 5 1 5 2 5 3 5 4 5 5 5
419 9 1133 1840 16 16 0 0 0 0 17 28 18 28
420 9 1170 1840 16 16 0 0 0 0 17 28 18 28
421 9 706 561 16 16 0 0 0 0 8 8 9 8 10 8 11 8
422 9 591 557 16 16 0 0 0 0 8 8 9 8 10 8 11 8
423 9 1896 1489 16 16 0 0 0 0 29 23 30 23
424 9 1871 1640 16 16 0 0 0 0 29 25
425 9 1839 1701 16 16 0 0 0 0 28 26
426 9 166 1433 16 16 0 0 0 0 2 21 3 21 2 22 3 22
427 9 169 1559 16 16 0 0 0 0 2 24 3 24
428 9 48 1556 16 16 0 0 0 0 0 24 1 24
429 10 1169 1103 18 9 0 0 0 0 16 16 17 16 18 16 19 16 16 17 17 17 18 17 19 17 16 18 17 18 18 18 19 18
430 10 1196 1103 18 9 0 0 0 0 16 16 17 16 18 16 19 16 16 17 17 17 18 17 19 17 16 18 17 18 18 18 19 18
431 10 1443 1074 18 9 0 0 0 0 22 16 23 16 22 17 23 17 22 18 23 18
432 10 1811 1092 18 9 0 0 0 0 27 16 28 16 29 16 27 17 28 17 29 17 27 18 28 18 29 18
433 10 1940 1088 18 9 0 0 0 0 29 16 30 16 31 16 29 17 30 17 31 17 29 18 30 18 31 18
434 10 6 308 284 18 9 0 0 0 0 0 4 1 4 2 4 3 4 4 4 5 4
435 10 231 282 18 9 0 0 0 0 0 4 1 4 2 4 3 4 4 4 5 4
436 10 1133 27 18 9 0 0 0 0 17 0 18 0
437 10 1300 2012 18 9 0 0 0 0 20 31 21 31
438 10 1145 1640 18 9 0 0 0 0 17 25 18 25
439 10 1208 1577 18 9 0 0 0 0 18 24 19 24
440 10 1151 1510 18 9 0 0 0 0 17 23 18 23
441 10 679 1641 18 9 0 0 0 0 10 25 11 25
442 10 713 1641 18 9 0 0 0 0 10 25 11 25
443 10 962 1689 18 9 0 0 0 0 14 26 15 26
444 10 164 281 18 9 0 0 0 0 0 4 1 4 2 4 3 4 4 4 5 4
445 10 77 1364 18 9 0 0 0 0 1 21 2 21
446 11 651 120 16 16 0 0 0 0 8 1 9 1 10 1 11 1 12 1 13 1 14 1 15 1 8 2 9 2 10 2 11 2 12 2 13 2 14 2 15 2
447 11 790 122 16 16 0 0 0 0 8 1 9 1 10 1 11 1 12 1 13 1 14 1 15 1 8 2 9 2 10 2 11 2 12 2 13 2 14 2 15 2
448 11 947 120 16 16 0 0 0 0 8 1 9 1 10 1 11 1 12 1 13 1 14 1 15 1 8 2 9 2 10 2 11 2 12 2 13 2 14 2 15 2
449 11 910 907 16 16 0 0 0 0 12 13 13 13 14 13 15 13 12 14 13 14 14 14 15 14
450 11 660 779 16 16 0 0 0 0 8 12 9 12 10 12 11 12